/res/Tilesets/grasstileset.gif
/res/Backgrounds/grassbg1.gif
/res/Music/level1-1.mp3
200
8
22 04 00 00 00 00 00 00 00 00 00 00 00 00 00 00 00 00 00 00 00 00 00 00 00 00 00 00 00 00 03 22 22 22 22 22 22 22 22 22 22 22 22 22 22 22 22 22 22 22 22 22 22 22 22 22 22 04 03 22 22 22 22 22 22 22 22 22 22 22 22 22 22 22 22 22 22 22 22 22 22 22 22 22 22 22 22 22 22 22 22 22 22 04 00 00 00 00 00 00 00 00 00 00 00 00 00 00 00 00 00 00 00 00 00 00 00 00 00 00 00 00 00 00 00 00 00 00 00 00 00 00 00 00 00 00 00 00 00 00 00 00 00 10 00 00 00 00 00 00 00 00 00 00 00 00 00 00 00 00 03 22 04 00 00 00 00 00 00 00 00 00 00 00 00 00 00 00 00 00 00 00 00 00 00 03 22 22 22 22 22 22 22 22 22 22 22 22 22 22
22 04 00 00 00 00 00 00 00 00 00 00 00 00 00 00 00 00 00 00 00 00 00 00 00 00 00 11 00 00 00 17 17 17 17 17 17 17 17 17 18 22 22 22 22 22 22 19 17 17 17 17 17 17 17 17 17 00 00 18 22 22 22 22 22 22 22 22 22 22 19 17 17 17 17 17 17 17 17 17 17 17 17 17 17 17 17 17 17 17 18 22 22 04 00 00 00 00 00 00 00 00 00 00 00 00 00 00 00 00 00 00 00 00 00 00 00 00 00 00 00 00 00 00 00 00 00 00 00 00 00 00 00 00 00 00 00 00 00 00 00 00 23 24 24 25 00 00 00 00 00 00 09 10 00 00 00 00 00 00 03 22 04 00 11 00 00 00 00 00 00 00 00 00 00 00 00 00 00 00 00 00 00 00 00 00 18 22 22 22 22 19 17 17 17 17 17 17 18 22
22 04 00 00 00 00 00 00 00 00 00 00 00 00 00 00 00 00 00 00 00 00 00 00 00 00 23 25 00 00 00 09 00 00 11 10 00 00 00 00 00 18 22 22 22 22 19 00 00 00 00 00 00 00 00 00 00 00 00 00 17 17 17 17 17 17 17 17 17 17 00 00 00 00 00 00 00 09 00 10 10 00 00 09 00 00 11 00 00 00 03 22 22 04 00 00 00 00 00 00 00 09 00 11 00 00 00 00 00 00 00 00 00 00 00 00 00 00 00 00 00 00 00 00 00 00 00 00 00 00 00 00 00 00 00 00 00 00 00 00 00 00 00 00 00 00 00 00 00 00 00 23 24 25 00 00 00 00 00 00 03 22 04 01 21 21 21 02 00 00 00 11 09 00 00 00 00 00 00 00 00 00 00 00 00 00 00 18 22 22 22 04 00 00 00 00 00 00 03 22
22 04 00 00 00 00 00 00 00 00 00 00 00 00 00 00 00 00 00 00 00 00 00 00 00 00 00 00 01 21 21 21 21 21 21 21 21 21 02 00 00 00 18 22 22 22 04 00 00 00 00 00 00 11 09 00 00 00 00 00 00 00 00 00 00 00 00 00 00 00 00 00 00 00 00 01 21 21 21 21 21 21 21 21 21 21 21 02 10 00 03 22 22 04 00 00 00 00 10 01 21 21 21 21 21 02 00 00 00 00 00 00 00 00 00 00 00 00 10 00 00 00 00 00 00 00 00 00 00 00 00 00 00 00 00 00 09 11 00 00 00 00 00 00 00 00 00 00 00 00 00 00 00 00 00 00 00 00 00 00 03 22 04 09 17 18 22 04 00 00 23 24 25 00 00 00 00 00 00 00 00 00 00 00 00 00 00 00 18 22 22 04 00 00 00 00 00 00 03 22
22 04 00 00 00 00 00 00 00 00 09 00 00 09 00 00 00 00 00 00 00 00 11 01 21 02 00 00 03 22 22 22 22 22 22 22 22 05 21 02 00 00 00 17 17 17 00 00 00 00 00 00 23 24 24 25 00 00 00 00 00 00 00 00 00 00 00 00 00 00 00 00 00 00 00 00 17 17 17 17 17 17 17 18 22 22 26 21 21 21 21 27 26 21 02 00 01 21 21 21 06 22 22 22 22 04 00 00 00 00 00 09 00 11 00 00 00 23 25 00 00 00 00 00 11 11 00 00 00 00 00 00 00 00 00 01 21 21 02 00 10 00 11 00 00 09 09 00 00 00 00 00 00 00 00 00 00 00 00 00 03 26 21 21 02 03 22 04 00 00 00 00 00 00 00 00 00 00 00 00 00 00 00 00 00 00 00 00 00 18 22 04 00 00 00 00 00 00 03 22
22 04 00 00 00 00 00 09 01 21 21 02 01 21 21 02 11 00 00 00 00 01 21 21 06 04 00 00 03 22 22 22 19 17 17 17 17 17 17 00 00 00 00 00 00 00 00 09 00 10 00 00 00 00 00 00 00 00 00 00 11 10 00 00 00 00 00 11 00 00 00 09 01 21 02 00 00 00 00 00 00 00 11 00 17 17 17 17 17 17 17 17 17 17 00 00 03 22 22 22 22 22 22 22 22 04 00 00 00 00 00 23 24 25 00 00 00 00 00 00 00 00 00 23 24 24 25 00 00 00 00 00 00 00 11 03 22 05 21 21 21 21 21 21 21 21 21 02 00 00 00 09 00 00 00 11 00 00 00 00 00 17 17 17 00 03 26 21 02 00 00 00 00 00 00 00 00 00 00 11 11 00 00 10 00 00 00 00 00 00 17 00 00 00 00 00 00 00 03 22
22 04 00 10 00 09 01 21 21 06 22 04 03 22 05 21 21 02 00 09 00 03 22 22 22 04 00 01 21 06 22 19 00 00 11 00 00 11 00 00 01 21 02 00 00 01 21 21 21 21 02 00 00 00 00 00 00 00 01 21 21 21 21 02 00 01 21 21 02 09 01 21 21 21 02 00 00 09 00 11 01 21 21 02 00 00 11 00 00 09 00 00 00 10 00 01 21 06 22 22 22 22 22 22 22 04 00 00 00 00 00 00 00 00 00 00 00 00 00 00 00 00 00 00 00 00 00 00 00 00 00 00 01 21 21 21 06 22 22 22 22 22 22 22 22 22 22 04 00 01 21 21 21 21 21 21 21 02 00 00 09 00 00 11 01 21 06 05 21 02 00 00 00 00 00 00 01 21 21 21 21 21 21 21 02 00 11 00 00 09 00 09 00 00 11 10 00 00 03 22
05 21 21 21 21 21 21 06 22 22 22 04 03 22 22 22 05 21 21 21 02 03 22 22 22 04 01 21 06 22 05 21 21 21 21 21 21 21 21 21 21 21 21 02 00 03 22 22 22 22 04 00 00 00 00 00 00 01 21 06 22 22 22 04 00 03 22 05 21 21 21 06 22 05 21 02 01 21 21 21 21 06 05 21 21 21 21 21 21 21 08 21 21 21 21 21 21 06 22 22 22 22 22 22 22 04 00 00 00 00 00 00 00 00 00 00 00 00 00 00 00 00 00 00 00 00 00 00 00 00 00 01 21 06 22 22 22 22 22 22 22 22 22 22 22 22 22 04 00 03 22 22 22 22 22 22 22 04 00 01 21 21 21 21 21 21 06 22 22 04 00 00 00 00 00 00 03 22 22 22 22 22 22 05 21 21 21 21 21 21 21 21 21 21 21 21 21 21 21 06
4
Slugger
6
1016 198 1112 198 2049 168 2369 78 5695 198 5876 198
Slogger
14
231 168 683 138 850 168 987 78 1243 168 1608 168 2140 168 2461 78 2597 198 3748 138 4121 108 4619 168 4974 48 5583 198
GiantSlugger
1
5844 170
Goomba
21
417 138 553 198 808 48 1039 78 1593 108 1748 198 2009 168 2700 108 2490 78 2391 78 2365 198 2837 198 2804 108 3079 78 3965 198 4257 138 4332 138 4890 108 5066 168 5030 138 5451 168

