/res/Tilesets/grasstileset.gif
/res/Backgrounds/grassbg1.gif
/res/Music/level1-1.mp3
20
8
22 04 00 00 00 00 00 00 00 00 00 00 00 00 00 00 00 00 03 22
22 04 00 00 00 00 00 00 00 00 00 00 00 00 00 00 00 00 03 22
22 04 00 00 00 00 00 00 00 00 00 00 00 00 00 00 00 00 03 22
22 04 00 00 00 00 00 00 00 00 00 00 00 00 00 00 00 00 03 22
22 04 00 00 00 00 00 00 00 00 00 00 00 00 00 00 00 00 03 22
22 04 00 00 00 00 00 00 00 00 00 00 00 00 00 00 00 00 03 22
22 04 00 00 00 00 00 00 00 00 00 00 00 00 00 00 00 00 03 22
05 21 21 21 21 21 21 21 21 21 21 21 21 21 21 21 21 21 21 06 
1
FloatingFucker
5
200 170 250 175 300 180 350 185 400 190